00000000-01000110
00000001-00000100
00000010-01000000
00000011-01100010
00000100-00111110
00000101-00000011
00000110-00011110
00000111-00011011
00001000-00011000
00001001-00011101
00001010-00010000
00001011-00011111
00001100-01110110
00001101-00000110
00001110-01000100
00001111-01110111
00010000-01111110
00010001-01101001
00010010-01010001
00010011-01001011
00010100-01011001
00010101-01110010
00010110-00000000
00010111-00000101
00011000-00100101
00011001-01101111
00011010-01010011
00011011-01100110
00011100-00000111
00011101-01011111
00011110-00010111
00011111-00111010
00100000-00100000
00100001-00001000
00100010-00101011
00100011-01110001
00100100-01001110
00100101-01101011
00100110-00000001
00100111-00010110
00101000-01100111
00101001-01001100
00101010-00011100
00101011-01000010
00101100-01000011
00101101-00011001
00101110-00110100
00101111-01111000
00110000-00100011
00110001-01010100
00110010-01110101
00110011-00111100
00110100-00101110
00110101-01001000
00110110-01111011
00110111-01111001
00111000-00100111
00111001-01100000
00111010-01001101
00111011-01110011
00111100-00110011
00111101-01001111
00111110-01011011
00111111-00010101
01000000-01111101
01000001-01001010
01000010-00010100
01000011-00100001
01000100-00111001
01000101-00001101
01000110-01100100
01000111-01011000
01001000-01011100
01001001-01000001
01001010-00010001
01001011-01000111
01001100-01101000
01001101-01111010
01001110-01010110
01001111-01101100
01010000-00101010
01010001-00101001
01010010-01011101
01010011-01101101
01010100-00001010
01010101-00110000
01010110-00000010
01010111-00111111
01011000-01111111
01011001-00001001
01011010-00101100
01011011-00110110
01011100-00110101
01011101-01001001
01011110-00001011
01011111-01010000
01100000-00011010
01100001-00111000
01100010-00111101
01100011-01100101
01100100-01011010
01100101-01100001
01100110-01110000
01100111-01101010
01101000-00010010
01101001-00100100
01101010-01000101
01101011-00110111
01101100-00001111
01101101-00110010
01101110-00100110
01101111-00001110
01110000-00110001
01110001-00111011
01110010-01011110
01110011-00101000
01110100-01110100
01110101-01010010
01110110-01100011
01110111-01010101
01111000-00001100
01111001-00101101
01111010-00010011
01111011-01101110
01111100-01111100
01111101-00101111
01111110-01010111
01111111-00100010
