00000000-00011011
00000001-01101101
00000010-00111001
00000011-00101110
00000100-00000100
00000101-00001111
00000110-00011100
00000111-01000010
00001000-00010110
00001001-00010001
00001010-01011100
00001011-00001000
00001100-00010011
00001101-01111010
00001110-01111110
00001111-01001101
00010000-00000001
00010001-00001100
00010010-00111111
00010011-01000100
00010100-01001011
00010101-00011111
00010110-00100100
00010111-01000111
00011000-01110010
00011001-00001001
00011010-00010101
00011011-00001110
00011100-01010100
00011101-00000011
00011110-01011000
00011111-01100000
00100000-00010000
00100001-00010111
00100010-01111001
00100011-01000101
00100100-00101000
00100101-01100111
00100110-01111111
00100111-01101001
00101000-00100011
00101001-01010111
00101010-01011101
00101011-00001011
00101100-00101100
00101101-00111010
00101110-00100111
00101111-00100010
00110000-01000011
00110001-00101101
00110010-00110100
00110011-01010110
00110100-00101111
00110101-01101000
00110110-00111100
00110111-01111000
00111000-00110000
00111001-01111101
00111010-00111011
00111011-01110101
00111100-00110011
00111101-01000000
00111110-01110100
00111111-01001001
01000000-00110101
01000001-01100110
01000010-00011110
01000011-00110001
01000100-00110111
01000101-01010101
01000110-01001100
01000111-00000000
01001000-00000111
01001001-01101011
01001010-00010100
01001011-00011001
01001100-00000101
01001101-00000010
01001110-00100001
01001111-01001000
01010000-01110000
01010001-00100000
01010010-00011010
01010011-01110011
01010100-01001110
01010101-00100101
01010110-00110110
01010111-01010011
01011000-01011011
01011001-01010001
01011010-00001101
01011011-00101001
01011100-00111110
01011101-01101110
01011110-01110001
01011111-00110010
01100000-01001010
01100001-00101010
01100010-01111011
01100011-01000001
01100100-01011110
01100101-01010000
01100110-01001111
01100111-00010010
01101000-01011001
01101001-01101100
01101010-01101111
01101011-01111100
01101100-01100011
01101101-00101011
01101110-00111000
01101111-01000110
01110000-01100101
01110001-01110110
01110010-00111101
01110011-01101010
01110100-01010010
01110101-01100100
01110110-00011101
01110111-01100010
01111000-00100110
01111001-00011000
01111010-01011111
01111011-00001010
01111100-01011010
01111101-00000110
01111110-01110111
01111111-01100001
