00000000-00110101
00000001-00001100
00000010-01010001
00000011-00100001
00000100-00010010
00000101-00000100
00000110-01010100
00000111-00010001
00001000-01011011
00001001-01011101
00001010-00101100
00001011-01111000
00001100-00101011
00001101-01111100
00001110-00110010
00001111-00000000
00010000-01100100
00010001-00000011
00010010-00010011
00010011-01000011
00010100-00110011
00010101-00111100
00010110-00100101
00010111-00010110
00011000-01001101
00011001-00100000
00011010-00101001
00011011-01011000
00011100-01000001
00011101-00001010
00011110-01001111
00011111-01001100
00100000-00101111
00100001-01011110
00100010-00110111
00100011-00011000
00100100-00011001
00100101-01100110
00100110-00110110
00100111-01010011
00101000-00010000
00101001-01101010
00101010-01110011
00101011-01001110
00101100-01010101
00101101-00001011
00101110-00111110
00101111-00111010
00110000-00101101
00110001-01110101
00110010-01101101
00110011-00001101
00110100-01110100
00110101-01001011
00110110-01100111
00110111-01111110
00111000-01101011
00111001-00011111
00111010-01101111
00111011-01011010
00111100-00110100
00111101-00011010
00111110-01010111
00111111-00100111
01000000-01100001
01000001-00111111
01000010-01000000
01000011-00011100
01000100-01010010
01000101-00011110
01000110-01100011
01000111-00101000
01001000-01000111
01001001-01000110
01001010-00011011
01001011-00001001
01001100-01111011
01001101-01111101
01001110-01001010
01001111-01011100
01010000-01100101
01010001-00010111
01010010-00100100
01010011-00110000
01010100-01011001
01010101-00100110
01010110-01111001
01010111-01000010
01011000-00111001
01011001-01110001
01011010-00010101
01011011-01101000
01011100-01101110
01011101-01001000
01011110-00100010
01011111-00111101
01100000-01110110
01100001-01110111
01100010-00010100
01100011-01010110
01100100-00111000
01100101-01100010
01100110-00001000
01100111-01011111
01101000-01010000
01101001-00101010
01101010-00110001
01101011-00000110
01101100-00001111
01101101-00001110
01101110-00111011
01101111-01110010
01110000-01111010
01110001-01111111
01110010-01110000
01110011-00000101
01110100-00000111
01110101-01001001
01110110-01101100
01110111-01000100
01111000-00000010
01111001-01100000
01111010-00100011
01111011-00000001
01111100-01000101
01111101-00101110
01111110-01101001
01111111-00011101
