00000000-01011110
00000001-01011010
00000010-01111001
00000011-00100100
00000100-01000110
00000101-01011011
00000110-00001011
00000111-00000000
00001000-01010001
00001001-01101101
00001010-00101000
00001011-01111010
00001100-01100011
00001101-00110000
00001110-00111101
00001111-01101111
00010000-00000110
00010001-00001100
00010010-01011111
00010011-01010000
00010100-01111100
00010101-01100101
00010110-00101011
00010111-00000100
00011000-00000010
00011001-00010010
00011010-01111011
00011011-01011101
00011100-01010011
00011101-00110011
00011110-01001001
00011111-00001010
00100000-00110111
00100001-00011001
00100010-01000100
00100011-00111011
00100100-01001110
00100101-00001110
00100110-00010101
00100111-01011000
00101000-01011001
00101001-01111000
00101010-00100110
00101011-01010100
00101100-00110010
00101101-01101011
00101110-00101110
00101111-00100101
00110000-00100001
00110001-01110100
00110010-00000011
00110011-00101111
00110100-01001010
00110101-01010101
00110110-00111010
00110111-01110011
00111000-01100010
00111001-00001101
00111010-00110001
00111011-01000011
00111100-01110010
00111101-01100110
00111110-00000001
00111111-00011100
01000000-00011011
01000001-00001001
01000010-01000111
01000011-01000010
01000100-01001011
01000101-01101000
01000110-00101100
01000111-01101100
01001000-01001000
01001001-00010000
01001010-00010100
01001011-00010001
01001100-01011100
01001101-01010111
01001110-01000101
01001111-00100111
01010000-01001101
01010001-00010011
01010010-01000000
01010011-00110101
01010100-01111101
01010101-00101101
01010110-01110101
01010111-01111111
01011000-00111001
01011001-01101110
01011010-00011101
01011011-00111100
01011100-01110111
01011101-01111110
01011110-00010111
01011111-00011111
01100000-01100111
01100001-01100100
01100010-00101010
01100011-00111111
01100100-00111110
01100101-01101010
01100110-01001111
01100111-00100010
01101000-00100000
01101001-01110000
01101010-00001000
01101011-00101001
01101100-01001100
01101101-00100011
01101110-00110100
01101111-00010110
01110000-01100000
01110001-01110110
01110010-00011000
01110011-00011010
01110100-00000111
01110101-01010110
01110110-01100001
01110111-01101001
01111000-00111000
01111001-01010010
01111010-00110110
01111011-01110001
01111100-00011110
01111101-01000001
01111110-00001111
01111111-00000101
